1111111111111
11P000C000111
100001100C111
1E000C00C0001
1111111111111
